PEDRO MENDES	SIEMENS
SÉRGIO SANTOS	RAM.JOSÉ
JOÃO PINHO	RAM.JOSÉ
LUÍS ESTEVES	INDIVIDUAL
JOSÉ ALVOEIRO	RAM.JOSÉ
PEDRO VASCO	D.MONTE REAL
CARLOS CAGICA	SIEMENS
TIAGO PENEDOS	EDP - LX
NUNO SILVA	BPI
JOSÉ PIRES	B.S.JOÃO
TIAGO NUNES	PROGRESSO
VLADMIR KLIKó	B.S.JOÃO
FILIPE SOUSA	PROGRESSO
MÁRIO CARVALHO	BPI
RUI VICENTE	SIEMENS
BRUNO SEMEDO	Q.LOMBA
EDUARDO QUARESMA	BPI
SÉRGIO PINA	BPI
FILIPE TAVEIRA	D.MONTE REAL
PAULO MARTINHO	QUEIJAS
RUI AGRELA	QUEIJAS
NELSON MOURINHO	B.S.JOÃO
LUÍS SENA	INDIVIDUAL
JÚLIO FERREIRA	B.S.JOÃO
JOÃO MIRANDA	D.MONTE REAL
ANDRÉ JOSÉ	D.MONTE REAL
JOÃO LAGO	SIEMENS
PRISCILIANO FERREIRA	RAM.JOSÉ
TIAGO FRANCISCO	SIEMENS
DIOGO CASQUIÇO	PROGRESSO
VALENTIN BRATOVANOV	QUEIJAS
TIAGO RODRIGUES	PROGRESSO
PAULO MALVA	INDIVIDUAL
JOSÉ PINTO	INDIVIDUAL
IVO MARQUES	SÃO PEDRO
RUI SANTOS	B.S.JOÃO
CARLOS PAIVA	CGD-LX